1111111111111
10010000000C1
1000011101001
1P0011C00E001
11111111111